====================
=B.................=
=...............====
=.=@..=.........=..=
=+==............=..=
=====.............==
=====.............==
======...........===
======...........===
=======.........====
=======.........====
====================