====================
=B..............000=
=...............====
=.=@..=.........=..=
=+==............=..=
=====.............==
=====...........GG==
======..........G===
======..........G===
=======0........====
=======0.......0====
====================